11111111
110PCE11
11111111
11111111